7 10
30 30 30 30 30 30 30 176 E 5
30 30 30 30 30 5 5 176 176  5
30 30 5 30 30 5 5 176 176 5
30 5 5 5 30 30 5 176 61 5
30 5 5 176 61 30 5 61 176 5 
30 C 5 176 176 61 61 30 176 5 
5 176 176 176 176 30 30 5 5  5